....................
.                  .
.                  .
.                  .
.                  .
.                  .
.                  .
.                  .
.                  .
.                  .
.                  .
.          ....    .
.                 ..
....              ..
....................